120 700
xxxxxxxxxxxxxxxxxxxxxxxxxx
x   0   x   2   x        x
x   0   x   2   x        x
x   0   x   2   x   55   x
x   x   x   x   x        x
x   x   x   x   x        x
x   x   x   x   x        x
x   x   x   x   x        x
x   x   x   x   x        x
x   x   x   x   x        x
x   x   1   x   3        x
x   x   1   x   3   44   x
x   x   1   x   3        x
xxxxxxxxxxxxxxxxxxxxxxxxxx