120 700
xxxxxxxxxxxxxxxxxxxxxxxxxx
x               x        x
x               x  3     x
x               x        x
x   xxxxxxxxx   xxxxxx   x
x           x   x    x   x
x           x   x 11 x   x
x           x 2 x    x   x
x   xxxxx   x   x    x   x
x   x   x   xxxxx    x   x
x   x 0                  x
x   x                    x
x   x                    x
xxxxxxxxxxxxxxxxxxxxxxxxxx