120 700
xxxxxxxxxxxxxxxxxxxxxxxxxx
x       x       x        x
x   1   x   2   x        x
x   3   x       x   00   x
x   x   x   x   x   00   x
x   x   x   x   x        x
x   x   x   x   x        x
x   x   x   x   x        x
x   x   x   x   x        x
x   x   x   x   x        x
x   x       x            x
x   x       x            x
x   x       x            x
xxxxxxxxxxxxxxxxxxxxxxxxxx